█████████████████████████████████████████
█     █     █     █       █     █   █   █
█ ███ █ ███ █ ███ █ █ █████ █ █ █ █ █ █ █
█ █ █ █  !█     █ █ █       █ █ █ █   █ █
█ █ █ █████ █████ █ █████████ ███ █████ █
█   █     █ █     █ █   █   █   █ █ █   █
██ █████ ███ ███ █ █ █ █ █ ███ █ █ █ █ ██
█ █ █   █ █   █   █ █ █   █   █ █   █ █ █
█ █ █ ███ █ ███████ █ ███████ █ ███ █ ███
█ █ █ █   █ █     █ █   █     █     █   █
█ █ █ █ ███ █ ███ █ ███ ███ ████████ ██ █
█   █ █   █     █ █   █   █ █   █   █ █ █
█ ███ ███ █████ █ ███ ███ █ █ █ █ █ █ █ █
█     █ █     █ █         █   █ █ █   █ █
████ █ █████ ███████ ████ ████ █ █████ ██
█   █ █ █   █ █     █ █   █   █   █     █
█ █ █ █ █ █ █ █ ███ █ █ █ █ █ █████ ███ █
█ █ █ █   █ █   █   █ █ █   █       █   █
█ █ █ █████ █████ █████ █ ███████████ ███
█ █ █         █ █     █ █ █   █     █ █ █
█ █ █████████ █ █████ █ ███ █ ███ ███ █ █
█ █ █       █ █     █?█ █   █   █     █ █
█ ███ █ █████ █ ███ ███ █ █████ ███ ███ █
█ █   █     █   █   █   █     █   █     █
█ █ ███████ █████ █████ █████ ███ █████ █
█ █ █     █     █     █   █   █ █ █     █
█ █ ███ ███████ █████ █ ███ ███ █ ███████
█ █ █   █     █     █ █         █ █     █
█ █ █ ███ ███ ███ ███ ███████████ █ ███ █
█ █ █       █   █   █           █     █ █
█ █ ███ ███████ ███ ███████████ ███████ █
█ █   █   █     █ █   █       █     █   █
█ ███ █████ ███ █ ███ █ ███ █ █████ █ ███
█   █ █     █   █   █ █ █ █ █   █   █   █
██ █ █ █████ ███ █ █ █ █ █ █████ █████ ██
█   █ █   █   █   █ █ █   █     █ █     █
█ ███ █ █ ███ █████ █ ███ █████ █ █ ███ █
█     █ █   █   █   █     █ █   █   █ █ █
█ █████████ ███ █ █ ███████ █ ███████ █ █
█           █     █         █           █
█████████████████████████████████████████